1111111111111111111111111111
1000090943004664403393904001
1111004005555665555030031111
1004094902225665222393934401
1111040042225665222000401111
1000090905555665555490900331
1111434000044664000400441111
1004090905555665555093940001
1111403404400660300003001111
1000093905555665555090900301
1111300342225665222300041111
1004390902225665222090943001
1111043045555665555404031111
1004094900340663004390930401
1111111111111111111111111111
